        MAP     =      [[101,91,91,91,91,91,91,91,91,91,91,91,91,91,91,91,91,91,91,91,91,91,91,91,102], 
                        [81,0, 0, 0, 0, 0, 0, 0, 0, 0, 0, 0, 0, 0, 0, 0, 0, 0, 0, 0, 0, 0, 0, 0, 79], 
                        [81,0, 0, 0, 0, 0, 0, 0, 0, 0, 0, 0, 0, 0, 0, 0, 0, 0, 0, 0, 0, 0, 0, 0,79], 
                        [81,0, 0, 0, 0, 0, 0, 0, 0, 0, 0, 0, 0, 0,71, 0, 0, 0, 0, 0, 0, 0, 0, 0,79], 
                        [81, 0, 0, 0, 0, 0, 0, 0, 0, 0, 0, 0, 0, 0, 0, 0, 0, 0, 0, 0, 0, 0, 0, 0,79],
                        [81, 0, 0, 0, 0, 0, 0, 0, 0, 0, 0, 0, 0, 0, 0, 0, 0, 0, 0, 0, 0, 0, 0, 0,79],
                        [81, 0, 0, 0, 0, 0, 0, 0, 0,71, 0, 0, 0, 0, 0, 0, 0, 0, 0, 0, 0, 0, 0, 0,79],
                        [81, 0, 0, 0, 0, 0, 0, 0, 0, 0, 0, 0, 0, 0, 0, 0, 0, 0, 0, 0, 0, 0, 0, 0,79],
                        [81, 0, 0, 0, 0, 0, 0, 0, 0, 0, 0, 0, 0, 0, 0, 0, 0, 0, 0, 0, 0, 0, 0, 0,79],
                        [81, 0, 0, 0, 0, 0, 0, 0, 0, 0, 0, 0, 0, 0,71, 0, 0, 0, 0, 0, 0, 0, 0, 0,79],
                        [81, 0, 0, 0, 0, 0, 0, 0, 0, 0, 0, 0, 0, 0, 0, 0, 0, 0, 0, 0, 0, 0, 0, 0,79],
                        [112,69,69,69,69,69,69,69,69,69,69,69,69,69,69,69,69,69,69,69,69,69,69,69,113]]
